111111111111111
111111111111111
111111111111111
1111A1 11111111
1            11
1   222 1  1  1
12  111  111  1
122 111       1
11  111      C1
1       222   1
12      2222221
11 222222111111
11 222222     1
1   1  1     11
11111SS11111111
